NO ./maps/gallery/512/bnb.xpm
SO ./maps/gallery/512/revolution.xpm
EA ./maps/gallery/512/regrets.xpm
WE ./maps/gallery/512/sebby.xpm

F 83,108,103
C 17,22,21

1111111111111
111111D100001
1000000100001
111111D111101
1000010000001
10100D0000001
1110011100101
10000100001D1
1D11111111101
1E00000000001
1111111111111
