NO ./maps/textures/no.xpm
SO ./maps/textures/so.xpm
EA ./maps/textures/ea.xpm
WE ./maps/textures/we.xpm

F 128,128,128
C 0,0,0


        1111111111111111111111111
        1000000000110000000000001
        1011000001110000000000001
        1001000000000000000000001
111111111011000001110000000000001
100000000011000001110111111111111
111101111111110111000000101C1
11110111111111011101010000001
11000000110101011100000010001
100000000000000011000000D0001
10000000000000001101010010001
11000001110101011111011110N0111
11110111 1110101 101111010001
11111111 1111111 111111111111
