NO ./no.xpm
SO ./so.xpm
EA ./ea.xpm
WE ./we.xpm

F 83,108,103
C 17,22,21


1111111111111
1000000000001
1000000111111
10000001
10000001
100N0001
10000001
11111111